SIZE
20;
21;
ENDSIZE
TILESET
1;
basic_walls.png;
ENDTILESET
TILE
4;
0,0,0;
0,32,0;
0,64,0;
0,0,32; // dummy black
ENDTILE
STRUCTURE
3,3,3,3,3,3,3,3,3,3,3,3,3,3,3,3,3,3,3,3;
3,3,3,3,3,3,3,3,3,3,3,3,3,3,3,3,3,3,3,3;
3,3,3,3,3,3,3,3,3,3,3,3,3,3,3,3,3,3,3,3;
3,3,3,3,3,3,3,3,3,3,3,3,3,3,3,3,3,3,3,3;
3,3,3,3,3,3,3,3,3,3,3,3,3,3,3,3,3,3,3,3;
3,3,3,3,3,3,3,3,3,3,3,3,3,3,3,3,3,3,3,3;
3,3,3,3,3,3,3,3,3,3,3,3,3,3,3,3,3,3,3,3;
3,3,3,3,3,3,3,3,3,3,3,3,3,3,3,3,3,3,3,3;
3,3,3,3,3,3,3,3,3,3,3,3,3,3,3,3,3,3,3,3;
3,3,3,3,3,3,3,3,3,3,3,3,3,3,3,3,3,3,3,3;
3,3,3,3,0,0,0,0,3,3,0,0,3,3,0,1,0,3,3,3;
3,3,3,3,2,0,1,1,2,0,2,0,3,3,2,0,0,3,3,3;
3,3,3,3,0,0,0,2,1,0,2,1,2,1,0,1,0,3,3,3;
3,3,3,3,0,0,0,3,0,2,0,1,0,2,0,0,0,3,3,3;
3,3,3,3,2,1,3,3,3,3,3,3,3,3,3,3,3,3,3,3;  // main platform
3,3,3,3,0,0,3,3,3,3,3,3,3,3,3,3,3,3,3,3;
3,3,3,3,0,0,3,3,0,0,1,0,1,0,0,1,3,3,3,3;
3,3,3,3,0,1,3,3,0,0,0,0,1,3,3,3,3,3,3,3;
3,3,3,3,0,0,0,0,2,2,0,0,3,3,3,3,3,3,3,3;
3,3,3,3,3,3,3,3,3,3,3,3,3,3,3,3,3,3,3,3;
3,3,3,3,3,3,3,3,3,3,3,3,3,3,3,3,3,3,3,3;
ENDSTRUCTURE
OBSTACLE
0,0,0,0,0,0,0,0,0,0,0,0,0,0,0,0,0,0,0,0;
0,0,0,0,0,0,0,0,0,0,0,0,0,0,0,0,0,0,0,0;
0,0,0,0,0,0,0,0,0,0,0,0,0,0,0,0,0,0,0,0;
0,0,0,0,0,0,0,0,0,0,0,0,0,0,0,0,0,0,0,0;
0,0,0,0,0,0,0,0,0,0,0,0,0,0,0,0,0,0,0,0;
0,0,0,0,0,0,0,0,0,0,0,0,0,0,0,0,0,0,0,0;
0,0,0,0,0,0,0,0,0,0,0,0,0,0,0,0,0,0,0,0;
0,0,0,0,0,0,0,0,0,0,0,0,0,0,0,0,0,0,0,0;
0,0,0,0,0,0,0,0,0,0,0,0,0,0,0,0,0,0,0,0;
0,0,0,1,1,1,1,1,1,1,1,1,1,1,1,1,1,1,0,0;
0,0,0,1,0,0,0,0,1,1,0,0,1,1,0,0,0,1,0,0;
0,0,0,1,0,0,0,0,0,0,0,0,1,1,0,0,0,1,0,0;
0,0,0,1,0,0,0,0,0,0,0,0,0,0,0,0,0,1,0,0;
0,0,0,1,0,0,0,1,0,0,0,0,0,0,0,0,0,1,0,0;
0,0,0,1,0,0,1,1,1,1,1,1,1,1,1,1,1,1,0,0;  // main platform
0,0,0,1,0,0,1,1,1,1,1,1,1,1,1,1,1,0,0,0;
0,0,0,1,0,0,1,1,0,0,0,0,0,0,0,0,1,0,0,0;
0,0,0,1,0,0,1,1,0,0,0,0,0,1,1,1,1,0,0,0;
0,0,0,1,0,0,0,0,0,0,0,0,1,0,0,0,0,0,0,0;
0,0,0,1,1,1,1,1,1,1,1,1,1,0,0,0,0,0,0,0;
0,0,0,0,0,0,0,0,0,0,0,0,0,0,0,0,0,0,0,0;
ENDOBSTACLE
