SIZE
20;
21;
ENDSIZE
TILESET
1;
basic_walls.png;
ENDTILESET
TILE
4;
0,0,0;  // black (none)
0,32,0;
0,64,0;
0,96,0;
ENDTILE
STRUCTURE
0,0,0,0,0,0,0,0,0,0,0,0,0,0,0,0,0,0,0,0;
0,0,0,0,0,0,0,0,0,0,0,0,0,0,0,0,0,0,0,0;
0,0,0,0,0,0,0,0,0,0,0,0,0,0,0,0,0,0,0,0;
0,0,0,0,0,0,0,0,0,0,0,0,0,0,0,0,0,0,0,0;
0,0,0,0,0,0,0,0,0,0,0,0,0,0,0,0,0,0,0,0;
0,0,0,0,0,0,0,0,0,0,0,0,0,0,0,0,0,0,0,0;
0,0,0,0,0,0,0,0,0,0,0,0,0,0,0,0,0,0,0,0;
0,0,0,0,0,0,0,0,0,0,0,0,0,0,0,0,0,0,0,0;
0,0,0,0,0,0,0,0,0,0,0,0,0,0,0,0,0,0,0,0;
0,0,0,0,0,0,0,0,0,0,0,0,0,0,0,0,0,0,0,0;
0,0,0,0,3,3,3,3,0,0,3,3,0,0,3,1,3,0,0,0;
0,0,0,0,2,3,1,1,2,3,2,3,0,0,2,3,3,0,0,0;
0,0,0,0,3,3,3,2,1,3,2,1,2,1,3,1,3,0,0,0;
0,0,0,0,3,3,3,0,3,2,3,1,3,2,3,3,3,0,0,0;
0,0,0,0,2,1,0,0,0,0,0,0,0,0,0,0,0,0,0,0;  // main platform
0,0,0,0,3,3,0,0,0,0,0,0,0,0,0,0,0,0,0,0;
0,0,0,0,3,3,0,0,3,3,1,3,1,3,3,1,0,0,0,0;
0,0,0,0,3,1,0,0,3,3,3,3,1,0,0,0,0,0,0,0;
0,0,0,0,3,3,3,3,2,2,3,3,0,0,0,0,0,0,0,0;
0,0,0,0,3,3,3,0,0,0,0,0,0,0,0,0,0,0,0,0;
0,0,0,0,0,0,0,0,0,0,0,0,0,0,0,0,0,0,0,0;
ENDSTRUCTURE
OBSTACLE
0,0,0,0,0,0,0,0,0,0,0,0,0,0,0,0,0,0,0,0;
0,0,0,0,0,0,0,0,0,0,0,0,0,0,0,0,0,0,0,0;
0,0,0,0,0,0,0,0,0,0,0,0,0,0,0,0,0,0,0,0;
0,0,0,0,0,0,0,0,0,0,0,0,0,0,0,0,0,0,0,0;
0,0,0,0,0,0,0,0,0,0,0,0,0,0,0,0,0,0,0,0;
0,0,0,0,0,0,0,0,0,0,0,0,0,0,0,0,0,0,0,0;
0,0,0,0,0,0,0,0,0,0,0,0,0,0,0,0,0,0,0,0;
0,0,0,0,0,0,0,0,0,0,0,0,0,0,0,0,0,0,0,0;
0,0,0,0,0,0,0,0,0,0,0,0,0,0,0,0,0,0,0,0;
0,0,0,1,1,1,1,1,1,1,1,1,1,1,1,1,1,1,0,0;
0,0,0,1,0,0,0,0,1,1,0,0,1,1,0,0,0,1,0,0;
0,0,0,1,0,0,0,0,0,0,0,0,1,1,0,0,0,1,0,0;
0,0,0,1,0,0,0,0,0,0,0,0,0,0,0,0,0,1,0,0;
0,0,0,1,0,0,0,1,0,0,0,0,0,0,0,0,0,1,0,0;
0,0,0,1,0,0,1,1,1,1,1,1,1,1,1,1,1,1,0,0;  // main platform
0,0,0,1,0,0,1,1,1,1,1,1,1,1,1,1,1,0,0,0;
0,0,0,1,0,0,1,1,0,0,0,0,0,0,0,0,1,0,0,0;
0,0,0,1,0,0,1,1,0,0,0,0,0,1,1,1,1,0,0,0;
0,0,0,1,0,0,0,0,0,0,0,0,1,0,0,0,0,0,0,0;
0,0,0,1,0,0,0,1,1,1,1,1,1,0,0,0,0,0,0,0;
0,0,0,1,1,1,1,0,0,0,0,0,0,0,0,0,0,0,0,0;
ENDOBSTACLE
